11111
1P001
1C0C1
100C1
10001
100E1
11111