11111111111111111111111111111
1c00E000000000000000000000001
10000000000000000000000000001
1P000000000000000000t00000001
1000C000000000000000000000001
10000000000000000000000000001
1000000000000000000000000p0c1
11111111111111111111111111111