11111111111
1P000000011
10110010101
1E1100C1111
11111111111