111111
1E0001
1C0001
1000P1
1000E1
100001
111111