1111111111111
10P10000E00C1
1000011111001
1000110000001
1111111111111