
1111111111111111111
1000000000000000001
1000000000011111001
1100P0000001C0C1001
1E00000000000000001
1100000C00000000001
1000000000000000001
1111111111111111111